NO ../textures/amethyst_160x160.xpm
C 23,51,12
SO ../textures/end_stone_160x160.xpm
F                       255,0,50
EA ../textures/grass_block_160x160.xpm


WE ../textures/warped_nylium_160x160.xpm



111 1
10N01
11111
