SO ../textures/cardinal/so.xpm
NO ../textures/cardinal/no.xpm
EA ../textures/cardinal/ea.xpm

C 15,55,40
                          WE ../textures/cardinal/we.xpm

F 200,200,200


                                                                                111111111 
                                                                               10100000001
                                                                               10000000001
                                                                              110000110001
                                                                               10000000001
                                                             11111111111111111111000000101
                                                            100000000000000000000000E00001
                                                             1111111111111111110011100001
                                                                               10000000101
                                                                               10000000001
                                                                               11111111111