NO ../textures/tmep/john_matangui.xpm
SO ../textures/tmep/monica_flema.xpm
EA ../textures/tmep/Hubble-Veil-Nebula-scaled-3566417318.xpm
WE ../textures/tmep/SDO_s_Ultra-high_Definition_View_of_2012_Venus_Transit__171_Angstrom_Full_Disc_-3990704513.xpm

F 20,20,20
C 10,10,40


11111111111
10000000001
10000000001
10000000001
10000000001
10000W00001
10000000001
10000000001
10000000001
10000000001
11111111111
