NO ../textures/amethyst_160x160.xpm
SO ../textures/end_stone_160x160.xpm
EA ../textures/grass_block_160x160.xpm
WE ../textures/warped_nylium_160x160.xpm

F 255,200,50
C 0, 100, 200

11111
10N01
11111