NO ../textures/amethyst_160x160.xpm
C 255,255,255
SO ../textures/end_stone_160x160.xpm
F                       255,0,50
EA ../textures/grass_block_160x160.xpm


WE ../textures/warped_nylium_160x160.xpm



1111111111111111111111111111111111111111111
10N0000000000000000000000000000000000000001
1000000000000000000000000000000000000000001
1000000000000000000010000000000000000000001
1000000000000000000010000001000000000000001
1000000000000000001010000001000000000000001
1000000000000000001010000001000000000000001
1000000000000000001010000001000000000000001
1000000000000000001010100001000000000000001
1000000000000000001010100001000000000000001
1000000000000000001010100001000000000000001
1001111111111110001010100001000000000000001
1000000000000000001010100001000000000000001
1000000000000001001010100001000000000000001
1000000000000001001000101001000000000000001
1000000000000001001000101000000000000000001
1000000000000001000000101000000000000000001
1000000000000101001000101010000001000000001
1000000000000101001000101010000001000000001
1000000000000101001000001010000001000000001
10000000000001010010000010010000001000000011111111111
1000000000000101001000001001000000100000001
1000000000000101001000001001000000100000001
1000000000000100001000001001000000100000001
1000000000000100001000000010000001000000001
1000000000000100001000000010000001000000001
1000000000000100001000000010000001000000001
1111111111111111111111111111111111111111111
